11111111111111111111111111111111111111111111111111
10000010000000000000000000000000000000000000000001
10000010000000000000000000000000000000000000000001
10000010000000000000000000000000000000000000000001
10000010000000000000000000000000000000000000000001
10000010000010000000100000010000000100000000000001
10000010000010000000100000010000000100000111111111
10000010000010000000100000010000000100000000000001
10000010000010000000100000010000000100000000000001
10000000000011111111100000011111111100000000000001
10000000000000000000000000000000000000000000000001
10000000000000000000000000000000000000000000000001
10000000000000000000000000000000000000000000000001
10000000000000000000000000000000000000100000000001
10000000000000000000000000000000000000100000000001
10000000010000000000000000000000000000100000000001
10000000010000000000000000000000000000100000000001
10000000010000000000000000000000000111111100000001
10000000010000000000001000010000000000100000000001
10000000010000000000001000010000000000100000000001
10000000010000000000001000010000000000100000000001
10001111111111100000001000010000000000100000100001
10000000010000000011111000011111000000000000100001
10000000010000000000000000000000000000000011111001
10000000010000000000000000000000000000000000100001
10000000010000000000000000000000000000000000100001
10000000010000000000000000000000000000000000000001
10000000010000000011111000011111000000000000000001
10000000000000000000001000010000000000001000000001
10000000000000000000001000010000000000001000000001
10000100000000000000001000010000000000001000000001
10000100000000000000001000010000000000001000000001
10011111000000100000000000000000000001111111000001
10000100000000100000000000000000000000001000000001
10000100000011111000000000000000000000001000000001
10000000000000100000000000000000000000001000000001
10000000000000100000000000000000000000001000000001
10000000000000000000000000000000000000000000000001
10000000000000000000000000000000000000000000000001
10000000000000000000000000000000000000000000000001
10000000000000000000000000000000000000000000000001
10000000000000111111111000000111111111000001000001
10000000000000100000001000000100000001000001000001
11111111100000100000001000000100000001000001000001
10000000000000100000001000000100000001000001000001
10000000000000100000001000000100000001000001000001
10000000000000000000000000000000000000000001000001
10000000000000000000000000000000000000000001000001
10000000000000000000000000000000000000000001000001
11111111111111111111111111111111111111111111111111
