00000010000000000000000000000000000000000000000000
00000010000000000000000000000000000000000000000000
00000010000000000000000000000000000000000000000000
00000010000000000000000000000000000000000000000000
00000010000000000000000000000000000000000000000000
00000010000010000000100000010000000100000000000000
00000010000010000000100000010000000100000111111111
00000010000010000000100000010000000100000000000000
00000010000010000000100000010000000100000000000000
00000000000011111111100000011111111100000000000000
00000000000000000000000000000000000000000000000000
00000000000000000000000000000000000000000000000000
00000000000000000000000000000000000000000000000000
00000000000000000000000000000000000000100000000000
00000000000000000000000000000000000000100000000000
00000000010000000000000000000000000000100000000000
00000000010000000000000000000000000000100000000000
00000000010000000000000000000000000111111100000000
00000000010000000000001000010000000000100000000000
00000000010000000000001000010000000000100000000000
00000000010000000000001000010000000000100000000000
00001111111111100000001000010000000000100000010000
00000000010000000011111000011111000000000000010000
00000000010000000000000000000000000000000001111100
00000000010000000000000000000000000000000000010000
00000000010000000000000000000000000000000000010000
00000000010000000000000000000000000000000000000000
00000000010000000011111000011111000000000000000000
00000000000000000000001000010000000000001000000000
00000000000000000000001000010000000000001000000000
00000100000000000000001000010000000000001000000000
00000100000000000000001000010000000000001000000000
00011111000000100000000000000000000001111111000000
00000100000000100000000000000000000000001000000000
00000100000011111000000000000000000000001000000000
00000000000000100000000000000000000000001000000000
00000000000000100000000000000000000000001000000000
00000000000000000000000000000000000000000000000000
00000000000000000000000000000000000000000000000000
00000000000000000000000000000000000000000000000000
00000000000000000000000000000000000000000000000000
00000000000000111111111000000111111111000001000000
00000000000000100000001000000100000001000001000000
00000000000000100000001000000100000001000001000000
11111111100000100000001000000100000001000001000000
00000000000000100000001000000100000001000001000000
00000000000000000000000000000000000000000001000000
00000000000000000000000000000000000000000001000000
00000000000000000000000000000000000000000001000000
00000000000000000000000000000000000000000001000000