1111111111111111111111111111111111111111111111111111
1000000100000000000000000000000000000000000000000001
1000000100000000000000000000000000000000000000000001
1000000100000000000000000000000000000000000000000001
1000000100000000000000000000000000000000000000000001
1000000100000000000000000000000000000000000000000001
1000000100000100000001000000100000001000000000000001
1000000100000100000001000000100000001000001111111111
1000000100000100000001000000100000001000000000000001
1000000100000100000001000000100000001000000000000001
1000000000000111111111000000111111111000000000000001
1000000000000000000000000000000000000000000000000001
1000000000000000000000000000000000000000000000000001
1000000000000000000000000000000000000000000000000001
1000000000000000000000000000000000000001000000000001
1000000000000000000000000000000000000001000000000001
1000000000100000000000000000000000000001000000000001
1000000000100000000000000000000000000001000000000001
1000000000100000000000000000000000001111111000000001
1000000000100000000000010000100000000001000000000001
1000000000100000000000010000100000000001000000000001
1000000000100000000000010000100000000001000000000001
1000011111111111000000010000100000000001000000100001
1000000000100000000111110000111110000000000000100001
1000000000100000000000000000000000000000000011111001
1000000000100000000000000000000000000000000000100001
1000000000100000000000000000000000000000000000100001
1000000000100000000000000000000000000000000000000001
1000000000100000000111110000111110000000000000000001
1000000000000000000000010000100000000000010000000001
1000000000000000000000010000100000000000010000000001
1000001000000000000000010000100000000000010000000001
1000001000000000000000010000100000000000010000000001
1000111110000001000000000000000000000011111110000001
1000001000000001000000000000000000000000010000000001
1000001000000111110000000000000000000000010000000001
1000000000000001000000000000000000000000010000000001
1000000000000001000000000000000000000000010000000001
1000000000000000000000000000000000000000000000000001
1000000000000000000000000000000000000000000000000001
1000000000000000000000000000000000000000000000000001
1000000000000000000000000000000000000000000000000001
1000000000000001111111110000001111111110000010000001
1000000000000001000000010000001000000010000010000001
1000000000000001000000010000001000000010000010000001
1111111111000001000000010000001000000010000010000001
1000000000000001000000010000001000000010000010000001
1000000000000000000000000000000000000000000010000001
1000000000000000000000000000000000000000000010000001
1000000000000000000000000000000000000000000010000001
1000000000000000000000000000000000000000000010000001
1111111111111111111111111111111111111111111111111111