11111111111111111111111111111111111111111111111111
10000001000000000000000000000000000000010000000001
10000001000000000000000000000000000000010000000001
10000001000000000000000000000000000000010000000001
10000001000000000000000000000000000000010000000001
10000001000000000000000000000000000000010000000001
10000001000000000000000000000000000000010000000001
10000001000000000000011111111000000000010000000001
10000000000000000000010000000000000000010000000001
10000000000000000000010000000000000111111111000001
10000000000000000000010000000000000000010000000001
10000000000000000000010000000000000000010000000001
10000000000000000000010000000000000000010000000001
11111100001111000000010000000000000000010000000001
10000000000000000000000000000000000000010000000001
10000000000000000000000000000000000000010000000001
10000000000000000000000000000000000000010000000001
10000000000000000000000000000000000000000000000001
10001000000000000000000001000000000000000000000001
10001000000000000000000001000000000000000000000001
10001000000000000000000001000000000000000000000001
10001000000000000000000001000000000000000000000001
10001000000000000000000001000000000000000000000001
11111111000000000000000001000000000000000000000001
10001000000000000000000001000000000000000000000001
10001000000000000000000001000000000000000000000001
10001000000000000000000001000000000011111111111111
10001000000000000000111111111110000000000001000001
10001000001111110000000000000000000000000001000001
10000000001000010000000000000000000000000001000001
10000000001000010000000000000000001000000001000001
10000000001000010000000000000000001000000001000001
10000000001000010000000000000000001111111111000001
10000000001000010000000000000000001000000001000001
10000000001000010000000111110000001000000001000001
10000000001000010000000000000000001000000001000001
10000000001000010000000000000000000000000001000001
10000000000000000000000000000000000000000001000001
10000000000000000000000000000000000000000000000001
10000000000000000000000000000000000000000000000001
10000000000000000000000000000000000000000000000001
11111111000000000000000001000000000000000000000001
10000000000000000000000001000000000000000000000001
10000000000000000000000001000000000000000000000001
10000000000000000000000001111111111111111000000001
10000000000000000000000001000000000000000000000001
10000000000000000000000001000000000000000000000001
10000000000000000000000001000000000000000000000001
10000000000000000000000001000000000000000000000001
11111111111111111111111111111111111111111111111111
