11111111111111111111111111111111111111111111111111
10000000011000000000000000000000000000000110000001
10000000011000000000000000000000000000000110000001
10000000011000000000001111111100000000000110000001
10000000011000000000011111111100000111111111110001
10000000000000000000011000000000000111111111110001
10000000000000000000011000000000000000000110000001
10000000000000000000011000000000000000000110000001
10000000000000000000011000000000000000000110000001
11111000011111100000011000000000000000000110000001
11111000011111100000000000000000000000000110000001
10000000000000000000000000000000000000000000000001
10000000000000000000000000000000000000000000000001
10000000000000000000000000000000000000000000000001
10000000000000000000000000000000000000000000000001
10000000000000000000000110000000000000000000000001
10000000000000000000000110000000000000000000000001
10000000000000000000000110000000000000000000000001
10001100000000000000000110000000000000000000000001
10001100000000000000000110000000000000000000000001
10001100000000000000000110000000000011111111111111
10001100000000000000000110000000000011111111111111
10001100000000000000000110000000000011111111111111
11111111110000000011111111111100000000000001100001
11111111110000000000000000000000000000000001100001
10001100000000000000000000000000000000000001100001
10001100000000000000000000000000011000000001100001
10001100000000000000000000000000011000000001100001
10001100000000000000000000000000011000000001100001
10000000000000000000000000000000011111111111100001
10000000000000000000000000000000011111111111100001
10000000000000000000000000111100011000000001100001
10000000000000000000000000111100011000000001100001
10000000000000000000000000000000011000000001100001
10000000000111100000000000000000011000000001100001
10000000011111111000000000000000011000000001100001
10000000011000011000000000000000000000000001100001
10000000011000011000000000000000000000000001100001
10000000011000011000000000000000000000000001100001
10000000011000011000000000000000000000000000000001
10000000011000011000000000000000000000000000000001
10000000011000011000000011000000000000000000000001
10000000011000011000000011000000000000000000000001
11111110000000000000000011000000000000000000000001
11111110000000000000000011111111111111111100000001
10000000000000000000000011111111111111111100000001
10000000000000000000000011000000000000000000000001
10000000000000000000000011000000000000000000000001
10000000000000000000000011000000000000000000000001
11111111111111111111111111111111111111111111111111
