11111111111111111111111111111111111111111111111111
10000011000000000000000001100000000000000000000001
10000011000000000000000001100000000000000000000001
10000011000000000000000001100000000000000000000001
10000011111000000000011111111110000000000000000001
10000011111000000000011111111110000000000000000001
10000000000000000000000001100000000000000000011111
10000000000000000000000001100000000000000000111111
10000000000000000000000001100000000000000000110001
10000000000000000000000001100000000000000000110001
10000000000000000000000001100000011000000000110001
10000000000000000000000000000000011000000000000001
10000000000000000000000000000000011000000000000001
10000000000000000000000000000000011000000000000001
11111111100000000000000000000000011000000000000001
11111111110000000000000000000000011000000000000001
10000000110000000000000000000000011000000000000001
10000000110000000000000000000011111111100000000001
10000000110000000000000000000011111111100000000001
10000000110000000000000000000000000000000000000001
10000000111111111000001111110000000000000000000001
10000000111111111000011111110000000000000000000001
10000000000000011000011000000000000000000011111111
10000000000000011000011000000000000000000111111111
10000000000000011000011000000000000000000110000001
10000000000000011000011000000000000000000110000001
10000000111111111000000000000000000001111110000001
10000000111111111000000000000000000011111110000001
10000000000000000000000000000000000011000000000001
10000000000000000000000000000000000011000000000001
10000000000000000000000000000000000011000000000001
10000000000000000000000000000000000011000000000001
10000000000000000000000000000000000011000000000001
10000000001111111110000000000000000000000000000001
10000000001111111110000000000000000000000000000001
10000000000000110000000000000000000000000000000001
10000000000000110000000000000000000000000111111111
10000000000000110000000000000000000000000111111111
10000000000000110000000000110000000000000000000001
10000110000000110000000000110000000000000000000001
10000110000000110000000000110000000000000000000001
10000110000000000000000000110000000000000000000001
10000110000000000000011111111111100000000000000001
11111110000000000000011111111111100000000000000001
11111100000000000000000000110000000000111100000001
10000000000000000000000000110000000000111110000001
10000000000000000000000000110000000000000110000001
10000000000000000000000000110000000000000110000001
10000000000000000000000000110000000000000110000001
11111111111111111111111111111111111111111111111111
