11111111111111111111111111111111111111111111111111
10000010000000000001000000000000000000000000000001
10000010000000000001000000000000000000000000000001
10000010000000000001000000000000000000000000000001
10000010000000000001000000000000000000000000000001
10000010000000001111111000000000000000000000000001
10000011110000000001000000000000000000000000111111
10000000000000000001000000000000010000000000100001
10000000000000000001000000000000010000000000100001
10000000000000000001000000000000010000000000100001
10000000000000000001000000000000010000000000100001
10000000000000000001000000000000010000000000100001
10000000000000000001000000000000010000000000000001
10000000000000000001000000000000010000000000000001
11111110000000000000000000000000010000000000000001
10000010000000000000000000000111111111000000000001
10000010000000000000000000000000000000000000000001
10000010000000000000000000000000000000000000000001
10000010000000000000000000000000000000000000000001
10000010000000000000000000000000000000000000000001
10000011111100000000000000000000000000000001111111
10000000000100000000000000000000000000000001000001
10000000000100000000001111100000000000000001000001
10000000000100000000001000000000000000000001000001
10000000000100000000001000000000000000000001000001
10000000000100000000001000000000000000111111000001
10000011111100000000001000000000000000100000000001
10000000000000000000001000000000000000100000000001
10000000000000000000000000000000000000100000000001
10000000000000000000000000000000000000100000000001
10000000000000000000000000000000000000100000000001
10000000000000000000000000000000000000000000000001
10000000000000000000000000000000000000000000000001
10000000000111111100000000000000000000000000000001
10000000000000100000000000000000000000000000000001
10000000000000100000000000000000000000000000000001
10000000000000100000000000100000000000000011111111
10000100000000100000000000100000000000000000000001
10000100000000100000000000100000000000000000000001
10000100000000100000000000100000000000000000000001
10000100000000100000000000100000000000000000000001
10000100000000000000000000100000000000000000000001
10000100000000000000000000100000000000000000000001
11111100000000000000000000100000000000111100000001
10000000000000000000000111111100000000000100000001
10000000000000000000000000100000000000000100000001
10000000000000000000000000100000000000000100000001
10000000000000000000000000100000000000000100000001
10000000000000000000000000100000000000000100000001
11111111111111111111111111111111111111111111111111
